###############
#           # #
# # ####### # #
# # #   # #   #
# ### ### ### #
#     #       #
###############
